"######",
"#.   #",
"#    #",
"# o @#",
"#    #",
"#    #",
"######", 
;
    
"#########",
"#.   o  #",
"#   @   #",
"# o   . #",
"#       #",
"#       #",
"#########", 

;       
"#######",
"#@   ##",
"# oo  #",
"# #. .#",
"#     #",
"#######", 